map_cols=20
map_rows=20
tile_width=40
tile_height=40
tile_path=map\map_town_40x40.png
tile_grid_id=1
back_layer_name=background
barrier_layer_name=obstacle
mask_layer_name=mask
<layer name=background>
38,38,38,38,38,38,38,38,38,39,39,39,38,35,38,39,39,39,39,39,
38,38,38,39,39,39,38,38,38,38,38,38,38,35,38,38,38,38,39,39,
39,38,38,39,39,39,39,39,39,38,38,38,39,35,38,38,38,38,38,39,
39,39,39,39,39,39,39,39,39,38,38,38,39,35,38,38,38,38,38,38,
39,39,39,39,39,38,39,39,39,38,38,38,39,35,38,38,38,38,38,38,
39,39,39,39,39,39,39,39,39,39,39,39,39,35,38,38,38,38,38,38,
39,39,39,39,39,39,39,39,39,39,39,39,39,35,38,38,38,38,38,38,
39,38,38,38,38,38,38,39,39,38,38,38,39,35,38,38,38,38,38,38,
39,38,38,39,39,39,39,39,39,39,38,38,39,35,38,38,38,38,38,38,
39,38,38,39,39,39,39,38,39,39,39,39,39,35,38,38,38,38,38,38,
38,38,38,38,38,39,39,39,39,39,39,38,39,35,38,38,38,38,38,38,
38,38,38,38,38,38,38,38,38,38,39,39,39,35,38,38,38,38,38,38,
38,39,39,39,39,39,39,39,39,39,39,39,39,35,39,39,39,38,38,38,
39,39,39,39,39,39,39,39,39,39,39,39,39,35,39,39,39,39,39,39,
34,34,34,34,34,34,34,34,34,34,34,34,34,34,34,34,34,34,34,34,
39,39,39,39,39,39,39,39,39,39,39,39,39,35,38,39,39,39,39,38,
38,38,38,38,38,38,38,38,38,38,38,39,39,35,38,38,38,38,38,38,
38,38,38,38,38,38,38,38,38,38,38,39,39,35,38,38,38,38,38,38,
38,38,38,38,38,38,38,38,38,38,38,39,39,35,38,38,38,38,39,39,
38,38,38,38,38,38,38,38,38,38,38,39,39,35,38,38,38,38,39,39
</layer>
<layer name=obstacle>
0,0,23,23,24,0,0,24,24,24,24,24,0,0,77,0,0,0,0,0,
0,0,23,23,24,90,91,0,0,81,82,83,77,0,77,0,13,14,15,0,
0,78,23,23,24,106,107,0,0,97,98,99,77,0,77,23,29,30,31,0,
0,78,108,108,0,0,0,0,28,28,28,28,77,0,77,23,19,19,19,19,
0,78,109,109,109,81,82,83,84,85,86,28,77,0,77,23,19,87,88,89,
0,78,78,78,0,97,98,99,100,101,102,28,77,0,0,23,19,103,104,105,
0,0,0,0,0,0,0,0,0,0,19,28,77,0,0,0,0,0,0,0,
0,79,79,79,79,79,79,79,79,0,19,28,77,0,0,0,0,111,112,24,
0,79,79,79,79,79,28,28,28,0,19,0,77,0,20,21,22,77,77,77,
77,77,77,77,77,77,0,0,0,0,0,0,77,0,20,22,21,87,88,89,
90,91,0,25,25,25,81,82,83,84,85,86,77,0,20,0,0,103,104,105,
106,107,109,109,109,109,97,98,99,100,101,102,0,0,20,0,0,0,0,0,
24,24,24,24,24,24,24,24,24,24,24,24,0,0,20,21,21,21,22,22,
108,108,108,108,108,108,108,108,108,108,108,108,0,0,20,21,22,22,111,112,
0,0,0,0,0,0,0,0,0,0,0,0,0,0,0,0,0,0,0,0,
80,80,80,80,80,0,0,0,0,0,0,0,0,0,79,79,79,79,79,0,
0,77,77,77,13,14,15,77,0,90,91,0,78,0,79,22,22,77,110,110,
0,0,110,77,29,30,31,77,0,106,107,0,78,0,79,22,22,77,110,109,
0,0,110,77,77,77,77,77,0,0,0,0,78,0,79,77,77,77,0,0,
0,0,110,109,109,109,109,109,0,78,78,78,78,0,79,0,0,0,0,0
</layer>
<layer name=mask>
0,0,7,7,8,74,75,0,0,65,66,67,61,0,61,0,0,0,0,0,
0,62,7,7,8,0,0,0,0,0,0,0,61,0,61,7,0,0,0,0,
0,62,92,92,0,0,0,0,12,12,12,12,61,0,61,7,3,3,3,3,
0,62,93,93,93,65,66,67,68,69,70,12,61,0,61,7,3,71,72,73,
0,62,62,62,0,0,0,0,0,0,0,12,61,0,0,7,3,0,0,0,
0,0,0,0,0,0,0,0,0,0,3,12,61,0,0,0,0,0,0,0,
0,63,63,63,63,63,63,63,63,0,3,12,61,0,0,0,0,95,96,8,
0,63,63,63,63,63,12,12,12,0,3,0,61,0,4,5,6,61,61,61,
61,61,61,61,61,61,0,0,0,0,0,0,61,0,4,6,5,71,72,73,
74,75,0,9,9,9,65,66,67,68,69,70,61,0,4,0,0,0,0,0,
0,0,93,93,93,93,0,0,0,0,0,0,0,0,4,0,0,0,0,0,
8,8,8,8,8,8,8,8,8,8,8,8,0,0,4,5,5,5,6,6,
92,92,92,92,92,92,92,92,92,92,92,92,0,0,4,5,6,6,95,96,
0,0,0,0,0,0,0,0,0,0,0,0,0,0,0,0,0,0,0,0,
64,64,64,64,64,0,0,0,0,0,0,0,0,0,63,63,63,63,63,0,
0,61,61,61,0,0,0,61,0,74,75,0,62,0,63,6,6,61,94,94,
0,0,94,61,0,0,0,61,0,0,0,0,62,0,63,6,6,61,94,93,
0,0,94,61,61,61,61,61,0,0,0,0,62,0,63,61,61,61,0,0,
0,0,94,93,93,93,93,93,0,62,62,62,62,0,63,0,0,0,0,0,
0,0,94,0,0,0,0,0,0,0,0,0,0,0,0,0,0,0,0,0
</layer>